جناب	PER
آقای	PER
خانم	PER
استاد	PER
مهندس	PER
دکتر	PER
پروفسور	PER
سید	PER
میر	PER
میرزا	PER
شیخ	PER
حاج	PER
حاجی	PER
حاجیه	PER
کربلایی	PER
ملا	PER
قاضی	PER
علامه	PER
حجت الاسلام	PER
حجت الاسلام والمسلمین	PER
آیت الله	PER
آیت الله العظمی	PER
حضرت	PER
امام	PER
امامزاده	PER
امام زاده	PER
شهید	PER
ارتشبد	PER
استوار	PER
پاسدار	PER
تیمسار	PER
دریادار	PER
ژنرال	PER
سپهبد	PER
ستوان	PER
سرتیپ	PER
سردار	PER
سرگرد	PER
سرلشگر	PER
سرهنگ	PER
سروان	PER
ناخدا	PER
پرزیدنت	PER
موسیو	PER
شاه زاده	PER
شاهزاده	PER
شاه	PER
سلطان	PER
شادروان	PER
مرحوم	PER
زنده یاد	PER
استان	LOC
شهر	LOC
شهرستان	LOC
روستای	LOC
دهکده	LOC
جزیره	LOC
شبهه جزیره	LOC
خلیج	LOC
دریای	LOC
دریاچه	LOC
رود	LOC
رودخانه	LOC
کویر	LOC
دشت	LOC
صحرای	LOC
کوه	LOC
رشته کوه	LOC
قله	LOC
اتوبان	LOC
خیابان	LOC
بلوار	LOC
کوچه	LOC
جاده	LOC
بزرگراه	LOC
آزادراه	LOC
میدان	LOC
چهار راه	LOC
چهارراه	LOC
سه راه	LOC
منطقه	LOC
شهرک	LOC
کوی	LOC
ورزشگاه	LOC
استادیوم	LOC
سالن	LOC
تالار	LOC
ترمینال	LOC
پارک سوار	LOC
پایانه	LOC
ایستگاه	LOC
فرودگاه	LOC
دفتر	LOC
دفتر مرکزی	LOC
دفتر خدمات	LOC
بازار	LOC
پاساژ	LOC
ساختمان	LOC
برج	LOC
مرکز خرید	LOC
مرکز تفریحی	LOC
مجتمع خرید	LOC
مجتمع تفریحی	LOC
مجتمع ورزشی	LOC
مجتمع فرهنگی	LOC
مجموعه ورزشی	LOC
مجموعه فرهنگی	LOC
مجموعه تفریحی	LOC
مجتمع فرهنگی ورزشی	LOC
مجموعه فرهنگی ورزشی	LOC
مجتمع مسکونی	LOC
ساختمان	LOC
استخر	LOC
مرقد	LOC
بقعه	LOC
آرامگاه	LOC
بارگاه	LOC
مقبره	LOC
حرم	LOC
امامزاده	LOC
امام زاده	LOC
مسجد	LOC
حسینیه	LOC
کلیسای	LOC
آتشکده	LOC
کاخ	LOC
قبرستان	LOC
گورستان	LOC
پارک	LOC
پارک آبی	LOC
بوستان	LOC
باغ وحش	LOC
دانشگاه	ORG
دانشکده	ORG
پژوهشکده	ORG
پژوهشگاه	ORG
جهاد دانشگاهی	ORG
حوزه علمیه	ORG
مدرسه	ORG
دبستان	ORG
دبیرستان	ORG
مهدکودک	ORG
آسایشگاه	ORG
خانه سالمندان	ORG
سرای	ORG
سازمان	ORG
باشگاه	ORG
بیمارستان	ORG
درمانگاه	ORG
کلینیک	ORG
آزمایشگاه	ORG
کتابخانه	ORG
موزه	ORG
هتل	ORG
مسافرخانه	ORG
کاروانسرای	ORG
مهمانسرای	ORG
اقامتگاه	ORG
خوابگاه	ORG
شیرخوارگاه	ORG
ندامتگاه	ORG
زندان	ORG
کلانتری	ORG
دادسرای	ORG
رستوران	ORG
سفره خانه	ORG
کافی شاپ	ORG
قهوه خانه	ORG
فروشگاه	ORG
آتلیه	ORG
آرایشگاه	ORG
آکادمی	ORG
آموزشگاه	ORG
مرکز آموزش	ORG
آژانس	ORG
آژانس مسافرتی	ORG
آژانس هواپیمایی	ORG
موسسه	ORG
شرکت	ORG
سفارت	ORG
سفارتخانه	ORG
اتحادیه	ORG
انجمن	ORG
بنیاد	ORG
پایگاه خبری	ORG

